111111111111
1P1000C00C01
10001001E0C1
111111111111