11111111111
1C100000C01
1E001000CC1
100010P0CC1
11111111111