111111111111111
1C1000Y0000RC01
1C1F00000000C01
1C100000000AC01
1E0010101000CC1
100I101010P0CC1
111111111111111