1111111111111111111
1E100000C0Y0000RC01
101F000000000000C01
101000000C000000C01
1010000000000000C01
1C1000000000000AC01
1000101010101000CC1
100I1010101010P0CC1
1111111111111111111