1111111111111111111
1011F10C00Y00000C01
1011010000000000C01
1011R1000C000000C01
1011010000000000C01
1C1000000000000AC01
1000101010101000CC1
100I101E101010P0CC1
1111111111111111111