1111111111111111111
1F11010C00000000C01
1I11010001111000C01
101101000C0Y1110111
1011011111111000C01
1C10000000000011111
1000101010101000001
10001R1E101010P0CA1
1111111111111111111