11111111111111111111111
100000C0010C00000000C01
10010101010001111000C01
10010101C1000C0Y1110111
10110111111111111000C01
1C00001C001000000011111
1C000010101010000011111
1C000000100010000011111
10000R101010101010A0001
10000I10101E101010P0C01
11111111111111111111111