111111111111
1Y1000C00001
1F0110010001
1000P0010001
1A10C00000R1
1010000C0111
101000000001
1I100C00C011
1000000000E1
111111111111