1111111111111111111
11C0000000000001C01
1C1000111111001Y101
10R10000010011C0101
1000100P10001000001
1000010000001000101
10C0000100001000101
10000001A0000000101
1F00ECC1111111001I1
1111111111111111111