111111111111111111111111111111
1CCCC100000CC00000000000000001
11100100000000010C000000100001
100001000011111111111100100001
100001000000000100000000100001
1000010011111101000000001C0001
1C0000001111110100111111111001
100000000000000000E11110001011
1000000ARIF0000000111111110101
1111111111111111000000Y0000101
100101110000000000P00000000101
100001110011111111111111111101
100001110000000000000000000101
100001110000111111111000000001
100001110000111111111000000001
100000000000000000000000000001
111111111111111111111111111111