111111111111
1Y1000C00001
100110010001
1000P0010001
1I10C0000001
1010000C0111
1T1X0R000001
111000000011
100000E00001
111111111111
