11111111111
1C100000101
1E1110101C1
10000P1CC01
11111111111