111111111111
1P0000C00001
100110010001
100010010001
1R10100000I1
1010000C0111
1T1000000001
11111110X011
1C0000000E01
111111111111