111111111111
1Y1000C00001
1R0110010001
1000P0010001
1T10C0000001
1010000C0111
10100X000001
1I100C00C011
1000000000E1
111111111111
