11111111111111111111
1P0000C0000000000001
100110010R0100010001
10001001111100010001
10C0100000000000I001
10001110000000111111
10000000000C0000T001
11111111011111111111
100000000000X0E00001
11111111111111111111