11111111111111111111
1P00000000000000C001
110110010R0100010001
10001001111100010001
10C01E0000000000T001
100I1110011111111111
10000000000000000001
10011111111111111111
10000000000000X00001
11111111111111111111