111111111111
1P0000Y00001
1C0000000001
111111100001
1F0000000E01
1I0000C00001
111111111111