11111111111
1P000Y00001
1C100000C01
1I1110101F1
1R000C100A1
100000000E1
11111111111