1111111111111111111111
1P0000C00001CCC00C0A01
11111111100010111111C1
10000000100010C0000111
100111101C000000000001
1001FI001111111111R001
1001111110000000010001
1000000000000000010001
1111111111111110010001
1Y01000001000000010001
1001001001011110010001
1000001000000E10000001
1111111111111111111111