111111111111111
1C1000Y0000RC01
101F10011111001
10100000A001001
1E00111110010C1
100I1CC000P0001
111111111111111