111111111111
1Y10F0C00001
10R110010001
1000P0010001
1010C0000001
1010000C0111
101000000001
1I100C00C011
100A000000E1
111111111111
