1111111111111111111
11C000000F000001CE1
1C1000111111001Y101
10R10000010011C0101
1000100010001000001
1000010000001000101
10C0000100001000101
10000001A0000000101
1P000CC1111111001I1
1111111111111111111