111111111111111111111111111111
1CCCC100000CC00000000000000001
11100100000000010C000000100001
100001000011111111111100100001
1000010000000001R0000000100001
1000010011111101000000001C0001
1C0001001111110100111111111001
100001000P00000000E11110001011
100000000000000000111111110101
1111111111111111000010Y1000101
1001A1110000000000000001000101
1000F1110111111111111111111101
100001110000000000000000000101
100001110000111111111000000001
1000011100001111111110000I0001
100000000000000000000000000001
111111111111111111111111111111