111111111111
1P1000C00001
100110010001
100000010001
1010C0000001
1010000C0111
10100I000001
100000000011
1R00X000T0E1
111111111111
